1111111111111111
1P00001000000001
1011101010110111
10101011101000C1
101000C100101011
1010111101101001
1010000001001001
1011111C11F11001
10100010F1110001
1000101111010111
1111101F01010001
1000101100011101
101000000101F101
1011111101010101
10000000010001E1
1111111111111111
