1111111111111111
1P00001000000001
1011101010110111
10101011101000C1
101000C100101011
1010111101101001
1010000001001001
1011111C11011001
1010001001110001
1000101111C10111
1111101001010001
1000101100011101
1010000001010101
1011111101010101
1000Z000010001E1
1111111111111111
